48,32,1100
=======================##=======
=======================##=======
=======================##=======
================================
================================
================================
=======================##=======
=======================##=======
=======================##=======
=======================##=======
=======================##=======
================================
================================
================================
=======================##=======
=======================##=======
=======================##=======
=======================##====##=
=======================##====##=
=======================##====##=
=======================##====##=
=======================##====##=
=======================##====##=
=======================##====##=
=======================##====##=
=======================##====##=
=============================##=
==========================##====
==========================##====
==========================##====
=============================##=
=============================##=
=============================##=
=============================##=
=============================##=
=============================##=
=============================##=
=============================##=
=============================##=
=============================##=
================================
================================
================================
================================
================================
================================
================================