48,32,1001,d
=========================##=====
=========================##=====
=========================##=====
=========================##=====
=========================##=====
=========================##=====
=========================##=====
=========================##=====
=========================##=====
=========================##=====
=========================##=====
=========================##=====
=========================##=====
================================
================================
======================##========
======================##========
======================##========
=============##=======##========
=============##=======##========
================================
================================
==================##============
==================##============
==================##============
================================
================================
======================##========
======================##========
======================##========
======================##========
======================##========
================================
================================
=========================##=====
=========================##=====
=========================##=====
=========================##=====
=========================##=====
=========================##=====
=========================##=====
=========================##=====
=========================##=====
=========================##=====
================================
================================
================================