48,32,1010
===========================##===
===========================##===
===========================##===
===========##==============##===
===========##==============##===
===========##===================
================================
================================
==========##==============##====
==========##==============##====
==========================##====
========##================##====
========##==============##======
========##==============##======
========================##======
================================
====================##==========
====##==============##==========
====##==============##==========
====##==============##==========
====##==============##==========
===*##==============##==========
====================##==========
================================
================================
================================
================================
================================
=============##=================
=============##=================
=============##=================
=============##=================
=============##=================
=============##=================
=============##=================
================================
================================
======##========================
======##========================
======##========================
======##========================
======##========================
======##========================
================================
====================##==========
====================##==========
====================##==========