48,32,0101
=============================##=
=============================##=
================================
================================
================================
================================
================================
=============================##=
=============================##=
=============================##=
=========================##==##=
=========================##==##=
=========================##==##=
=========================##==##=
=============================##=
======================##=====##=
======================##=====##=
======================##========
===================##===========
===================##===========
===================##===========
======================##========
===============##=====##=====##=
===============##=====##=====##=
===============##============##=
=========================##==##=
============##===========##==##=
============##===========##==##=
============##===========##==##=
=============================##=
=========##==================##=
=========##==================##=
=========##=====================
================================
======##========================
======##========================
======##========================
=============================##=
===##========================##=
===##========================##=
===##========================##=
=============================##=
##===========================##=
##===========================##=
##===========================##=
##===========================##=
=============================##=