48,32,0101,d
===##===========================
===##===========================
===##===========================
===##==============##===========
===================##===========
===================##===========
===================##===========
===================##===========
===================##===========
===================##===========
================================
================================
================================
================================
================================
================================
============##==================
============##==================
============##==================
============##==================
============##==================
============##==================
============##==================
============##==================
============##==================
============##==================
============##==================
================================
================================
================================
=====##=========================
=====##=========================
=====##=========================
=====##=========================
=====##=========================
=====##=========================
=====##=========================
=====##=========================
=====##=========================
=====##=========================
=====##=========================
=====##=========================
=====##=========================
=====##=========================
=====##=========================
=====##=========================
=====##=========================